####################################################################################################
# #      ##   ### #      #  #     #   #   #    # ##      #       # #           ##   ##   #       # #
# S#####    #  #  # # ##   #  # #   #  ##  # # #    ####   ## # #   # # ## ###    #    #  # # ##   #
# #    #######   ##  #  # #  ##  ##  # # #   #  # # #   # #    #  # #  #   #  #### #### #  #    ####
# # ##      # # #  #  # # # #  #   ##     ##  #  ## # # ##  # #  #  ###  ##  #   # #     #  # #    #
# #   ## ## #    #  # # # #  # ###   ####    # #   #  #  # #  # ###   # #  #   # #  # ##  #  #  ## #
#  ## # # #  ###   ## # # # #     ## #   ## #   ##  #  #   # #   # ##   ##   # #  #    # #  #  #   #
##  # #   # #   # #     #    # ##  #   # #  # # #  #  # ###  # # # # ###   ##   # ## #  #  # ## # ##
## #  ## #  # #   # ## # ###  ##  # ## # # #  #  #   #    # ## # #   #   ##  # #    #  #  #       ##
#  # #    # #  # #   ##     #    #    ##  #  ###  ##### # #   ## # #   ##   ##  # #   # # # #####  #
# #  ## ##  ## #  ##  # ###  # #   # #   #  ###  #   #   # ## #  # # ## # #   #  #  # #   # #     ##
#   # #  # #    #  # #  #  # ## ###  # ##  # #  #  #   ##   # # ###      ### # # # ###  ##  ### #  #
####    #  # ##  ##   #  #        ###  # #   # #  # ####  # # #  #  ####  #    #  ###  ##  #   # # #
#   ## ## ## # # #  #  #  # #####     #  ## #    #       #  # ##  # #   #   ##  #  #  #   #  #    ##
# #    #  #    #   # #  #  #    #### # #  #  # # # ## # #  ##  ##  #  #  ###  # # ## #  ##  # # #  #
#  # ##  #  ### # #   #  # # ##     #   #  #  #    # ##  ##  #   # ##  #   # #  # #  # ### #   # # #
###   # #  #     # ##  # # #   ### #  #  #  #  ####    #   #   # #   #  # #    ##   #   #  # #     #
#   # # # ## ###    ##  #  # # #    ##  # #  #    ## #  ##  # # #  #  ##    ###  ## # #   #   #### #
# ##  # # #  #  ###  # #  ## #  ###    #  # # ###   # # ###   #   # #   # ##  # ## #   #### #    # #
# #  #  ##  #  #   #    #   #  #   ### # #       ## #    # ###  ##   ## #   #   #   # #    # # #  ##
# # # #    # #   #  # # # # ##   # #   #   ##### #   # #   # # #   # #  ###  # #  # # # ##    # #  #
#  #   # ##    ####  ## # #  # ##   # #  ###      ##  #  # #     #  #  #  # ##   #  # # # ###     ##
##  ##  #   ###  # #    #  #  #   ##  # #   # ###   #   #   ####  #  #  # #    ##  # #  # # # # ## #
# #    #  ###  #    ### # #  #  ###  #    #  #   # # ###  ##   ##  # # #   ####  # #   #       #   #
#  # #  # #   #  ##    #  # # #    #  ## # #   #  #    ##    #  # #  # # #     # #  ## # # # # # # #
## #  # #   #  ## # # #  #  #   ##  #   #  ######   ##   #### #  #  #  # ### #    #  # ####   #  # #
##   #   ## # #     ##  # # # #   #  ##  #     ## ##   # #    ##  #  # #   #  ###  # #   #  ##  ## #
#  ##  # # #  # ####   #    #### # #   #  # ##    #  ## #  ##   # # #  # # ##    ##  # # # # # #   #
# #  ####    #       ## ###   #    # ## #   # ### # #     #### ## # # # ##   ### #  #  # #   # # # #
# ##   #  ### ### ####    # # # ###  #  ####    ##  # ## # ## #   ##  #   # #  #   #  #   ###  # # #
#    #   ##      #     ##  ## # #   ## #     # #   #    #     # ##   ## #    #  ###  #### #   #   ##
# ### ###   ## #  # ###  #    ##  ##   # ### # # #  # #   # # # #  ##    ###   #    ###   # #####  #
# #      # #  #  #  # # # ####   #   ### # #  #   ##   ###   ##  # #  ###   ##  # #  #  ##    #   ##
# # # ## # # ## #  #         ###  # #    #  #  ##   # #   # #   #  # #    #   # #  ##  ### # #  # ##
#  # #     #    ## # ### ###   ## # ## ##  ###  # # #   ##  # #### ## # #  ## # # #   ###   #  #   #
##     ####  # #   #   #   # #    #       # ###  ##  ##  # ##   ##    # # #   # ##  #  #  # # #  # #
# # # #   # #  # # ###  ## # ### ## # # ###  # #   #   # #   ##   # # #  #  ###   #  ##  #  #  ##  #
#  # #  #  #  #   #   #  #  #   #    # #   #     #  ## ##  # # ## # #  # # ##  ## ##    ## ###   # #
# #    # ##  #  ##  #  #### # #  # #   # #  # #####  #  # #    #  #  #   #   #      ####    # ##  ##
#   ## #   #  #  # # #   #    ##  # ## # ##  #   #  # # #  ## ## #  # # #  #  ### #     # ##    #  #
# #   #  #  #  # # #  ## # # #  # #    #  ## # #   #  #  # ###   ###   #  # #    # #### # #  ##  # #
# ### # #  # # #     # # #  # # # ## # # #   #  ##  # ## #  #  ##    # ####  ### #    # ##  ### ## #
#   # # ## # # ## # #     #     #   #  # # ####  # #      # # ##  ####     #     # ###   # # #     #
# # # #  #   #   #  # ###  #### # #  ##  # # ### ##  ####   #    #    ####  # # #     ##   # # ### #
# # ##  # # # ## # #  #  ##   #  # #    #  #  ##    ##   ## ## ##  # #   # ##  #  ###   ## # # #   #
# #    #  #    # # # #  #   #  # #  ## # #  #    ###   #  #   #   ##   ###    #  ##  ##  ##  #  # ##
#  #### #  # # #  #  # #  ##  ##  #   #    #  ## #   ## #  ## # #   ###   # ## #   #   #    # #  ###
# ##      #  #  # ## # # #   #   ### #  #### #  #  ###   #   #  ###     # ##    ## # #  # ##  ##  ##
#    ## # # # # #  # #   # #  # # #   # #      #  #   # # ##   #   ######    # ##   # # #   #   #  #
# ###  #  # #    #   ####   # # #   # # # # #####   #       ##### #      ## ## #  ##     ##   #  # #
##   #   #  # ### ###    ## # #  # #  # # ##   # ####### # #   #   # # #   #   # #   ## #  # # #   #
## # ##### #      #   ## ## # ##   # #   #   #      #   #   ##   #  ## # # # ##  # ## #  #  #   # ##
#  #       # ####   ## #    #   ####  ##   ### # ##   #  ##  # #  #   #  # # #  #  #   #  # # #  # #
# # ## # ## #    # #    ## #### #   #  ####   ##  ###  #   # #  # # #  ##  #  # # ## #  # #    #   #
# #     #   # ##  # # #   # #   # # ##    # #   #    #  # #   ##  ## #  # # #   # #  # ## #### # # #
# # # # # #     #   # ## #   # #  #   ### #  ##  # #  #  #  ##   #   ## #    # #   # #        #  # #
# # ### #  # # # ## #   #  #   # # ## # # # #  #  ###  # # #   ##  ##   # ##  #  #  #  # ####   #  #
#  #   # #  # #   # # #  # # # #   #    # # # # #  #  #  #   ##   #   ##  # #   # #  ## #    ###  ##
## # #   ##     # #  # #    # # ##  ## ## # #   # #  #  # ###   ##  ### # #  ###   #    # ## # # # #
##   # #   ####  # # #   ## #    ##  # #  # # # #  #  #       #  # #    #  #     #  ###    # # #   #
#  ###  ##    # #  #  ####  ### #   ##   ## # #  # # ### ## ## # # # # ### # ######    # # # #   # #
# #   #   # ### # # #     #     # ##  ###   # ###  #  #  # # #   # # #  #    #   # # ## # ## # ## ##
#   # ###  #    #   # ### # # ###    #    ##     #  ### #    # ##  #  #  # # # #    #        #  #  #
####    # #  #### #  #  # #  #    # #  ###   # #  #     # # ##  # # #  # #  ##  # # # ## #### #  # #
#   # # #   #      #  # #  ##  ### #  #  # # ## #  # # #  #    #  #  #  # #   #  #  #   #      #   #
# #  #  ## #  # # # #    #  # #    # #  #  ##   # # # #  # ## #  #  ### #  ##  #  #  ## # ## #  ## #
#  # # #  #  #   #   # #  # # # ## # ##   #   # #     # #    #  # #  #    #  #  # ##    #  # ###   #
## # #  #   #  ### #  #  #  #  #   #  # ##  ##  # # ### # # #  #    #  ##  #  # #  ## ## # #    # ##
## #  #  # # # #   ## # #  # # # #  #  #   #  #  ##     #  #  # # #  # # #   #   #  ##   #### # #  #
#  #####   #   # ##    # #   # #  #  #   ##  # # #  # ##  #  #     # ##   # # ##  #    #   #  #   ##
# #   # ##  # #   # ## #   ###   ### # ##  #   #  ###    # #  # # #     # # #   #  #### ##  #  ### #
#   #     #  # ##  ### ###    ### ##  #  #   #  #    # #    # # #  ## ##  #   # # #      ##  #     #
# #  # # #  #    # ##    ### #      #  # # ### # ### ##### #   ###   #   ## # # #  # # #  # # #### #
##  #  #  # # # #    # #      # ###  # #   #       #   #    ##  ### #  ##    ##  # # #  ### #      #
#  #  #  #  # # # ## # ### # #     #   # ##  ## # # ## # ##  ##  #  ##  # ###   #  ### #    # # # ##
# #  #  #  #  # ##   ##   # #  ## # # #    #   #  #  #  #  #   # # #  # # #   ##  #    # # #   #  ##
##  # ##  #  #     ##   #    #  ##   # ## ## ##  #  # #  #  ###  # # ## ##  # ## #  # #  #  ###  # #
#  #     ### # # #  # ## ###  #    # #   #   #  # #    #  #     #  # #   # ###   ## #  #  ##   #   #
# #  #### #   # ### # #  #  #  ### # # #   ##  #   # #  #  # # #  #   # #  ##  ##    #  # #  #  ## #
#  #    # # ##   # ##  #   # # # ##  # # ##  #  ##    #  # #  # # # # # # #   #   ##  # # # ### #  #
##  ### # #    #     #  ##   #      ##  #   # #  # # ## #   # #    ##     # ##  #  # # ##    #  # ##
### # #    ## # ####   #   ## ### ##   #  #   ## # #   #  ##  # ## #  ####    ## #  #    # # # # # #
###    ### # #     ####  #    #  #   ##  # ##  # # ###  #    ###   ####   ###      ## ##  #  #     #
##  ## # #    # ##      # ###  #   ## # ##  # #   #   # #######  ##     #    ### # #  # # ##  # # ##
#  #     #### #  ### ###      # # #     #  #  # ##  # #      #  #   # #  ###   #  #  #  #   ####   #
# #  ## #   #  #   #    # # ### # # ## #  #  ##    ##  ## ## # ## # ## # #   #  #  #  #  ##   #  # #
# ## # #  #  # # # ### #   ##     #  #  #   #  ####  #    #  #     #   # # #  ##  #  # #  # # # #  #
#   #    ## #  # #   # # #   # ### #  # ###  # #    # ## # #  ## ##  # # # ##  # ## #   #  #  # ## #
# # # ###    #  #  # #  # ##   #    ###    # #   ## # # #   # #  #  ##  #    # # #  # #  #   #    ##
# #   #  # #  #  #  # #    # ### ##    # # #   ##   #    ## #  ##  #  # # ##  ## # #  ##   ## ###  #
#  # #  #  ###  # # #  ###  #      # # # #  ##  ###   ##  #  # #  # # #  #   #   # # # ####      # #
## ##  ###   # #    # #   #  # ## #  # #  # #  #   # # ##   #   # #   # #  ##  ### # #    ## # #   #
##   #  ####   # ## #   ## #  #  #  #   ##  #### #  #   # ##  ##   # #  # # # #    # # # #   # # # #
# ##  #  #  ### ##  # # #   #  #   # ##    #      #   #  #   #   ##   # #     # ####  ##   # #  #  #
#    ###   ##     #  #    ##  # # #    # # # ##### # #  ## ## # ##  # #  # ## # #   #   # ## # #  ##
# # # # # ##  # # # #  ##  # #    # ##  ## # #      # #    ##   #  #  ## ###  # # #  ## # #  #  # ##
#  #      #  #  # #   #   #  # ##   # # #  #  ## ##    # ##   ##  # #  #    ###  # #    #  ## # #  #
## ### ## #### ## #### ###  #    #### #  ## # ## # # #  ## # #   ##  #  # #    # # # ### ##   # # ##
#      #       #           #  ##       #         #    #      # #    ###    # #   #          #   # E#
####################################################################################################
