##################
#E# #       #    #
#     # # #   ####
# # ##  ## # #   #
# # #  #    #  # #
#  #  ## ##  # # #
# #  #     #   # #
# # # # ##  # ## #
##  # #  ##  #   #
#  #    #S # # # #
##   # # # ##   ##
### # #  #   ##  #
##  #   # ## ### #
#  # # #   #  #  #
## #     # ##   ##
#   ### #   #### #
# #     # #      #
##################
