##########
#      # #
##S### # #
# #  #   #
#   # ## #
# #   #  #
#  # #  ##
# # ## # #
#       E#
##########
