############
##      #  #
#  # # #E ##
# #S##  #  #
# # # # ## #
###   # #  #
#   #     ##
# # ### #  #
# #    ### #
#  ###  #  #
##  #  #  ##
############
