###############
# #          ##
# S#### # ##  #
# #    #  ### #
#   ##  #  #  #
## # # # #  # #
###  # #   #  #
##  #   # #  ##
#  #  ##  # ###
# ## #   #  ###
# #   # # #  ##
# # ##  # ##  #
# # #  #     ##
#     #  # # E#
###############
