########################################
# #    #   #      # #   #       #   #  #
# S# #   # # # ##     # # # ## #  #   ##
# ##  # #  # #  ### ##    ## # ###  # ##
# #  #  # # # #    #  ####   #   # #   #
# # #  #  #    ###  #      # ### # #####
# #  #  #   ##     #  # # # #    #     #
#  #  #  ######## #  #### #   ### ## # #
##  #  # #  ##   #  # #   # ##      ## #
## #  #   #    ### #  # ###   ### #    #
#   # # #  # ##     # #    ##   #  ### #
# #  #  # #     ####   # #  # # ##   # #
#  #   # #  # ##    # # # #  #    ## # #
##  # #    #     ##        #   ##    #E#
########################################
