##########
###     ##
##S ###  #
# ### # ##
# #   #  #
#   ## # #
# #      #
##  ######
#  #     #
# # # ## #
#    ##  #
## #   # #
# # ##   #
#   # ## #
## #   # #
#    ##  #
# # ### ##
# #  #   #
#  #   #E#
##########
