##############################
# ###    #         ## #  #   #
# S#  ##  ### # ##     #   # #
## # #  #    #  #  # #  # ## #
#  # ## ####  #  ###  #   #  #
# #   #     # # #   #  # #  ##
#  ##  ## # #  #  # ##  ## # #
##   # #   # # # ##   # #    #
#  #   # #       #  #   # ##E#
##############################
